New Palette=Img/地图/New Palette
Decorations=Img/地图/NewBG/Decorations/Decorations
Home=Img/地图/NewBG/Home
ThrG=Img/地图/NewBG/ThrG
上挥=Img/技能/刀光/上挥
刺=Img/技能/刀光/刺
拳=Img/技能/刀光/拳
挥=Img/技能/刀光/挥
斩钢闪=Img/技能/刀光/斩钢闪
轮=Img/技能/刀光/轮
manN=Img/新骨骼/manN
剑预制=Prefabs/Attack/剑预制
太刀预制=Prefabs/Attack/太刀预制
拳预制=Prefabs/Attack/拳预制
枪预制=Prefabs/Attack/枪预制
FireBoss=Prefabs/Boss/FireBoss
WerwolfBoss=Prefabs/Boss/WerwolfBoss
Bleed=Prefabs/Buff/Bleed
BuffManager=Prefabs/Buff/BuffManager
Burn=Prefabs/Buff/Burn
Retard=Prefabs/Buff/Retard
Vertigo=Prefabs/Buff/Vertigo
出头草1=Prefabs/Cao/出头草1
出头草2=Prefabs/Cao/出头草2
卷尾草=Prefabs/Cao/卷尾草
圆石头1=Prefabs/Cao/圆石头1
圆石头2=Prefabs/Cao/圆石头2
木桩（短）=Prefabs/Cao/木桩（短）
木桩（长）=Prefabs/Cao/木桩（长）
树=Prefabs/Cao/树
树枝=Prefabs/Cao/树枝
树桩=Prefabs/Cao/树桩
椭圆石头=Prefabs/Cao/椭圆石头
横木=Prefabs/Cao/横木
泥土狼爪印=Prefabs/Cao/泥土狼爪印
浆果=Prefabs/Cao/浆果
浆果丛=Prefabs/Cao/浆果丛
浮萍=Prefabs/Cao/浮萍
湖中石=Prefabs/Cao/湖中石
红山花=Prefabs/Cao/红山花
苔藓=Prefabs/Cao/苔藓
草里狼爪印=Prefabs/Cao/草里狼爪印
蓝山花=Prefabs/Cao/蓝山花
藤曼=Prefabs/Cao/藤曼
郁金香=Prefabs/Cao/郁金香
鹅卵石=Prefabs/Cao/鹅卵石
黄山花=Prefabs/Cao/黄山花
Enemy-1-1=Prefabs/Character/Enemy/Enemy-1-1
Enemy-1-2=Prefabs/Character/Enemy/Enemy-1-2
Enemy-1-3=Prefabs/Character/Enemy/Enemy-1-3
Enemy-1-4=Prefabs/Character/Enemy/Enemy-1-4
Enemy-1-5=Prefabs/Character/Enemy/Enemy-1-5
Enemy-1-6=Prefabs/Character/Enemy/Enemy-1-6
Werwolf-01=Prefabs/Character/Enemy/Werwolf-01
Werwolf=Prefabs/Character/Enemy/Werwolf
Man6=Prefabs/Character/Player/Man6
man10=Prefabs/Character/Player/man10
man16=Prefabs/Character/Player/man16
move=Prefabs/Character/Player/move
Player=Prefabs/Character/Player/Player
Player0=Prefabs/Character/Player/Player0
Player01=Prefabs/Character/Player/Player01
Item=Prefabs/Item/Item
SkillSlot=Prefabs/Item/SkillSlot
Slot=Prefabs/Item/Slot
TemMan6=Prefabs/OldMan/TemMan6
attack=Prefabs/Skill/attack
FireRain=Prefabs/Skill/BossSkill/FireBoss/FireRain
火元素火球=Prefabs/Skill/BossSkill/FireBoss/火元素火球
火雨掌控者=Prefabs/Skill/BossSkill/FireBoss/火雨掌控者
Selecter=Prefabs/Skill/Selecter
skill-01=Prefabs/Skill/skill-01
skill-02=Prefabs/Skill/skill-02
skill-03=Prefabs/Skill/skill-03
SkillSelector=Prefabs/Skill/SkillSelector
TemSkillSummoner=Prefabs/Skill/TemSkillSummoner
一点火=Prefabs/Skill/一点火
冰凌=Prefabs/Skill/冰凌
凤仙火=Prefabs/Skill/凤仙火
地凸冰=Prefabs/Skill/地凸冰
怒吼炮=Prefabs/Skill/怒吼炮
悬浮剑=Prefabs/Skill/悬浮剑
摔炮=Prefabs/Skill/摔炮
暴风雪=Prefabs/Skill/暴风雪
熏风=Prefabs/Skill/熏风
白雷=Prefabs/Skill/白雷
线熔岩=Prefabs/Skill/线熔岩
落冰雪=Prefabs/Skill/落冰雪
集落雷=Prefabs/Skill/集落雷
零星火=Prefabs/Skill/零星火
HurmNumberUI=Prefabs/UI/HurmNumberUI
影子=Prefabs/UI/影子
传送点=Prefabs/传送点
箱子=Prefabs/箱子
门=Prefabs/门
